AGF Agen - La Garenne
AHZ Alpe d'Huez -  
AJA Ajaccio - Campo Dell'Oro
ANE Angers - Marce
ANG Angouleme - Brie-Champniers
AUF Auxerre - Branches
AUR Aurillac -  
AVF Avoriaz -  
AVN Avignon - Caumont
BAE Barcelonnette - Saint-Pons Airport
BES Brest - Guipavas
BIA Bastia - Poretta
BIQ Biarritz/Bayonne - Parme (Bayonne-Anglet)
BOD Bordeaux - Merignac
BOR Belfort - Fontaine
BOU Bourges -  
BSL Basel - EuroAirport
BVA Beauvais - Tille
BVE Brive-La-Gaillarde - La Roche
BZR Beziers - Vias
CCF Carcassonne - Salvaza
CDG Paris - Roissy Ch. de Gaulle
CEQ Cannes - Mandelieu/Metropolitan Area]
CER Cherbourg - Maupertus
CET Cholet - Le Pontreau
CFE Clermont-Ferrand - Aulnat
CFR Caen - Carpiquet
CHR Chateauroux - Deols
CLY Calvi - Sainte Catherine
CMF Chambery - Aix-Les-Bains
CMR Colmar - Houssen
CNG Cognac - Chateau Bernard
CQF Calais - Calais-Dunkerque
CSF Creil -  
CTT Le Castellet -  
CVF Courchevel -  
DCM Castres - Mazamet
DIJ Dijon - Longvic
DLE Dole - Tavaux
DNR Dinard/Pleurtuit - St. Malo
DOL Deauville - Saint Gatien
DPE Dieppe - Saint-Aubin
DXA Deux Alpes -  
EAP Basel - Basel/Mulhouse EuroAirport
EBU Saint-Etienne - Boutheon
EDM La Roche Sur Yon - Les Ajoncs
EGC Bergerac - Roumaniere
ENC Nancy - Essey
EPL Epinal - Mirecourt
ETZ Metz/Nancy - Lorraine
EVX Evreux - Fauville
FNI Nimes - Arles-Camargue (Garons)
FRJ Frejus - Saint-Raphael
FSC Figari - Sud-Corse
GAT Gap - Tallard
GFR Granville -  
GNB Grenoble - Saint Geoirs
HZB Hazebrouck - Merville Calonne Airport
IDY Ile d'Yeu - Le Grand Phare
JCA Cannes - Croisette Heliport
JDP Paris - Heliport
JLP Juan-les-Pins - Broye-les-Pesmes
JPU Paris - La Defense Heliport
JSZ St. Tropez - Heliport
LAI Lannion - Servel
LBG Paris - Le Bourget
LBI Albi - Le Sequestre
LBY La Baule - Escoublac
LDE Lourdes/Tarbes - Ossun
LDV Landivisiau -  
LEH Le Havre - Octeville
LIG Limoges - Bellegarde
LIL Lille - Lesquin
LME Le Mans - Arnage
LPY Le Puy-en-Velay - Loudes
LRH La Rochelle/Ile de Re - Laleu
LRT Lorient - Lann-Bihoue
LSO Les Sables - Talmont
LTQ Le Touquet - Paris-Plage
LTT St Tropez - La Mole
LVA Laval - Entrammes
LYN Lyon - Bron
LYS Lyon - Saint-Exupery/Satolas
MCU Montlucon - Gueret
MEN Mende - Brenoux
MFX Meribel - Bois-des-Fraises
MLH Mulhouse - Basel/Mulhouse EuroAirport
MPL Montpellier - Frejorgues
MRS Marseille - Marignane-Provence
MVV Megeve -  
MXN Morlaix - Plaujean
MZM Metz - Frescaty
NCE Nice - Cote d'Azur
NCY Annecy - Meythet
NIT Niort - Souche
NTE Nantes - Nantes Atlantique/Chateau Bougon
NVS Nevers - Fourchambault
OBS Aubenas -  
ORE Orleans -  
ORY Paris - Orly
PAR Paris - Metropolian Area
PAW Pamiers - Les Pujols
PGF Perpignan - Rivesaltes
PGX Perigueux - Bassillac
PIS Poitiers - Biard
PLG La Plagne -  
POX Pontoise - Cormeilles-en-Vexin
PRP Propriano -  
PUF Pau - Pyrenees - Pont Long Uzein / Pyrenees
QAI Aime -  
QAM Amiens - Glisy
QBH Levallois -  
QBM Bourg St. Maurice - Ceyzeriat
QBQ Besancon - Thise
QEV Courbevoie -  
QFC Creteil -  
QIE Istres - Le Tube Airbase
QJZ Nantes - Nantes Railway Station
QMU Moutiers -  
QNJ Annemasse -  
QNL Neuilly-sur-Seine (Paris) -  
QNX Macon - Charnay
QRV Arras - Roclincourt
QTJ Chartres - Champhol
QUX Caudebec-en-Caux -  
QVG Vilgenis -  
QVI Valbonne -  
QXB Aix-En-Provence - Les Milles
QXG Angers - Angers Railway Station
QXK St.-Genis - St.-Genis Bus Service
QYR Troyes - Barberey
QYW Cannes - Vieux Port/Palm Beach
QZE Mont-Louis - Laquillane
QZF Font Romeu -  
QZG La Llagone -  
QZH Les Angles -  
QZV Roissy-en-France -  
QZW Fictitious Point/Air France2 -  
QZX Fictitious Point/French Government -  
QZY Fictitious Point/Air France -  
RCO Rochefort - Saint-Agnant
RDZ Rodez - Marcillac
RHE Reims - Champagne
RNE Roanne - Renaison
RNS Rennes - Saint-Jacques
RSY Sita Aircom Network/Roissy Ch. de Gaulle -  
RYN Royan - Medis
SBK Saint Brieuc - Armor
SCP St.-Crepin - St.-Aubin-sur-Durance
SEC Serre Chevalier -  
SNR Saint-Nazaire - Montoir
SOZ Solenzara -  
SXB Strasbourg - Entzheim
SXD Sophia Antipolis - Heliport
SYT Saint-Yan -  
TFR Tarbes - La Loubere
TGF Tignes -  
TLN Toulon/Hyeres - La Palyvestre Navy
TLS Toulouse - Blagnac/Toulouse CCER
TNF Toussus-Le-Noble -  
TUF Tours - Val De Loire / Saint-Symphorien
UIP Quimper - Pluguffan
URO Rouen - Vallee de Seine/Boos
VAF Valence - Chabeuil
VAZ Val d'Isere -  
VHY Vichy - Charmeil
VNE Vannes - Meucon
VTL Vittel - Champ-des-Courses
XAB Abbeville -  
XAC Arcachon - La Teste de Buch
XAG Agde -  
XAI Aix-les-Bains -  
XAM Amboise - Dierre
XAN Alencon - Val Frambert
XAS Ales - Deaux
XAT Antibes -  
XAV Albertville -  
XBA Bareges -  
XBC Briancon -  
XBD Bar-le-Duc - Les Hauts de Chee
XBF Bellegarde - Vouvray
XBH Bethune -  
XBI Le Bourg-d'Oisans - Bourg d'Oisans
XBK Bourg-en-Bresse -  
XBM Beaulieu-sur-Mer -  
XBP La Baule-les-Pins -  
XBQ Blois - Le Breuil
XBS Boulogne-sur-Mer -  
XBT Boulogne-Billancourt -  
XBU Bagnols-sur-Mer -  
XBV Beaune - Challanges
XBX Bernay - St Martin
XBY Bayonne -  
XBZ Bandol -  
XCB Cambrai - Off-line Point
XCC Le Creusot/Montceau-les-Mines/Montchanin - Pouilloux
XCD Chalon-sur-Saone - Champforgeuil
XCE Cerbere -  
XCF Chamonix/Mont Blanc -  
XCG Cagnes-sur-Mer -  
XCK Saint-Die - Remomeix
XCP Compiegne - Margny
XCQ Chamrousse -  
XCR Chalons-sur-Marne -  
XCS Caussade -  
XCT La Ciotat -  
XCU Collioure -  
XCV Chantilly -  
XCW Chaumont - Semoutiers
XCX Chatellerault - Targe
XCY Chateau-Thierry - Belleau
XCZ Charleville-Mezieres -  
XDA Dax - Seyresse Army
XDB Lille - Lille Europe Railway Station
XDC Dives-sur-Mer/Cabourg - Dives/Cabourg Airport
